Homework 11-8-2022
An Interactive Fiction by Radha
Release 1 / Serial number 221107 / Inform 7 v10.1.2 / D

Nether Fortress
The Nether Fortress is hot. There are  dead Blazes and Wither Skeletons on the floor. There is a Chest in front of you. There is a Bastion in the north of you. Your portal needs a Fire Charge.

You can see a Nether Portal, a Wither Skeleton Corpse (in which is a Wither Skull), a Blaze Corpse (in which is a Blaze Rod) and a Nether Fortress Chest (closed) here.

>go to portal
You can't see any such thing.

>go to Portal
You can't see any such thing.

>Open Portral
You can't see any such thing.

>Open Portal
The portal is locked you fool!

It seems to be locked.

There are 20 minutes to escape!

>open table
It isn't something you can open.

There are 20 minutes to escape!

>open chest
It seems to be locked.

There are 20 minutes to escape!

>play solitare
That's not a verb I recognise.

>take laptop
Taken.

There are 20 minutes to escape!

>go north
Darkness
It is pitch dark, and you can't see a thing.

You see a faint glow coming form a light switch.

There are 20 minutes to escape!

>turn on switch
You switch the light switch on.

There are 20 minutes to escape!

Living Room
There is a comfy sofa set in front of the television. To the south is a classroom.

There is a Happy Clown standing in the corner of the room staring at you. A golden key is dangling from its brightly colored belt.

You can also see a light switch here.

>grap key
That's not a verb I recognise.

>grab key
That's not a verb I recognise.

>take key
That seems to belong to the Happy Clown.

There are 20 minutes to escape!

>go south
Classroom
There are two rows of chairs in the classroom. To the north through the a short hallway is a living room. 

You can see a Portal, a table and a treasure chest (closed) here.

There are 20 minutes to escape!

>open chest
It seems to be locked.

There are 20 minutes to escape!

>use key on chest
That's not a verb I recognise.

>unlock chest
(with the laptop)
That doesn't seem to fit the lock.

There are 20 minutes to escape!

>unlock chest withy key
I didn't understand that sentence.

>unlock chest with key
You can't see any such thing.

>hold key
You can't see any such thing.

>hold golden key
You can't see any such thing.

>go north
Living Room
There is a comfy sofa set in front of the television. To the south is a classroom.

There is a Happy Clown standing in the corner of the room staring at you. A golden key is dangling from its brightly colored belt.

You can also see a light switch here.

There are 20 minutes to escape!

>attack happy clown
Violence isn't the answer to this one.

There are 20 minutes to escape!

>kiss happy clown
The Happy Clown might not like that.

There are 20 minutes to escape!

>give happy clown laptop
The Happy Clown reaches out to you screaming while making no noise! You hand the clown the laptop and it tosses the key to you.
You also suddenly remember the portal in the classroom. Quick! Use the key to unlock the portal and escape!

There are 7 minutes to escape!

>grab key
That's not a verb I recognise.

>take key
You already have that.

There are 6 minutes to escape!

>go south
Classroom
There are two rows of chairs in the classroom. To the north through the a short hallway is a living room. TIME IS RUNNING OUT!

You can see a Portal, a table and a treasure chest (closed) here.

There are 5 minutes to escape!

>open treasure chest
It seems to be locked.

There are 4 minutes to escape!

>use golden key on treasure chest
That's not a verb I recognise.

>unlock treasure chest with golden key
You unlock the treasure chest.

There are 3 minutes to escape!

>open treasure chest
You open the treasure chest, revealing an Electro Gadget.

There are 2 minutes to escape!

>take electro gadget
Taken.

There is 1 minutes to escape!

>open portal
The portal is locked you fool!

It seems to be locked.

There are 0 minutes to escape!

>unlock portal
What do you want to unlock the Portal with?

>electro gadget
You unlock the Portal.

You didn't make it to the portal. The curse of the golden key consumes you!

    *** The End ***

Would you like to RESTART, RESTORE a saved game, QUIT or UNDO the last command?

* * *

Homework 11-8-2022
An Interactive Fiction by Radha
Release 1 / Serial number 221107 / Inform 7 v10.1.2 / D

Nether Fortress
The Nether Fortress is hot. There are  dead Blazes and Wither Skeletons on the floor. There is a Chest in front of you. There is a Bastion in the north of you. Your portal needs a Fire Charge.

You can see a Nether Portal, a Wither Skeleton Corpse (in which is a Wither Skull), a Blaze Corpse (in which is a Blaze Rod) and a Nether Fortress Chest (closed) here.

>grab Wither Skull
That's not a verb I recognise.

>take Wither Skull
Taken.

There are 20 minutes to escape!

>Enter Bastion
You can't see any such thing.

>Go North
Darkness
It is pitch dark, and you can't see a thing.

You see a faint glow coming from a redstone torch.

There are 20 minutes to escape!

>turn on redstone torch
You switch the Redstone Torch on.

There are 20 minutes to escape!

Bastion
There is a strange redstone contraption in the Bastion. If you use the Wither skull on the Unfinished Wither, you may get something important!

You can see a Redstone Torch here.

>use Wither Skull on the Unfinished Wither
That's not a verb I recognise.

>unlock unfinished Wither with Wither Skull
You can't see any such thing.

>unlock Unfinished Wither with Wither Skull
You can't see any such thing.

* * *

Homework 11-8-2022
An Interactive Fiction by Radha
Release 1 / Serial number 221107 / Inform 7 v10.1.2 / D

Nether Fortress
The Nether Fortress is hot. There are  dead Blazes and Wither Skeletons on the floor. There is a Chest in front of you. There is a Bastion in the north of you. Your portal needs a Fire Charge.

You can see a Nether Portal, a Wither Skeleton Corpse (in which is a Wither Skull), a Blaze Corpse (in which is a Blaze Rod) and a Nether Fortress Chest (closed) here.

>grab wither skull
That's not a verb I recognise.

>take wither skull
Taken.

There are 20 minutes to escape!

>go north
Darkness
It is pitch dark, and you can't see a thing.

You see a faint glow coming from a redstone torch.

There are 20 minutes to escape!

>turn on redstone torch
You switch the Redstone Torch on.

There are 20 minutes to escape!

Bastion
There is a strange redstone contraption in the Bastion. If you use the Wither skull on the Unfinished Wither, you may get something important!

You can see an Unfinished Wither (closed) and a Redstone Torch here.

>unlock unfinished wither with wither skull
The Wither activates. Destruction quickly awaits the nether. A Chest Key is dropped for you to pick upUse the Fire Charge to unlock the Nether Portal and escape!

There are 7 minutes to escape!

>go south
Nether Fortress
The Nether Fortress is hot. There are  dead Blazes and Wither Skeletons on the floor. There is a Chest in front of you. There is a Bastion in the north of you. Your portal needs a Fire Charge.TIME IS RUNNING OUT!

You can see a Nether Portal, a Wither Skeleton Corpse (empty), a Blaze Corpse (in which is a Blaze Rod) and a Nether Fortress Chest (closed) here.

There are 6 minutes to escape!

>unlock Nether Fortress Chest with Chest Key
You unlock the Nether Fortress Chest.

There are 5 minutes to escape!

>open Nether Fortress Chest
You open the Nether Fortress Chest.

There are 4 minutes to escape!

* * *

Homework 11-8-2022
An Interactive Fiction by Radha
Release 1 / Serial number 221107 / Inform 7 v10.1.2 / D

Nether Fortress
The Nether Fortress is hot. There are  dead Blazes and Wither Skeletons on the floor. There is a Chest in front of you. There is a Bastion in the north of you. Your portal needs a Fire Charge.

You can see a Nether Portal, a Wither Skeleton Corpse (in which is a Wither Skull), a Blaze Corpse (in which is a Blaze Rod) and a Nether Fortress Chest (closed) here.

>search wither skeleton
You can't see any such thing.

>search Nether Fortress
I only understood you as far as wanting to search the Nether Portal.

>look
Nether Fortress
The Nether Fortress is hot. There are  dead Blazes and Wither Skeletons on the floor. There is a Chest in front of you. There is a Bastion in front of you. Your portal needs a Flint and Steel.

You can see a Nether Portal and a chest (closed) here.

There are 20 minutes to escape!

>Search Wither Skeleton corpse
You can't see any such thing.

* * *

Homework 11-8-2022
An Interactive Fiction by Radha
Release 1 / Serial number 221107 / Inform 7 v10.1.2 / D

Nether Fortress
The Nether Fortress is hot. There are  dead Blazes and Wither Skeletons on the floor. There is a Chest in front of you. There is a Bastion in the north of you. Your portal needs a Fire Charge.

You can see a Nether Portal, a Wither Skeleton Corpse (in which is a Wither Skull), a Blaze Corpse (in which is a Blaze Rod) and a Nether Fortress Chest (closed) here.

>take Wither Skull / go north / turn on restone torch / unlock Unfinished Wither with Wither Skull/ go south/ unlock Nether Fortress Chest with Chest Key/ Open Nether Fortress/ Open Portal with Fire Charge
I only understood you as far as wanting to take the Wither Skull.

>take Wither Skull
Taken.

There are 20 minutes to escape!

>go north
Darkness
It is pitch dark, and you can't see a thing.

You see a faint glow coming from a redstone torch.

There are 20 minutes to escape!

* * *

>turn on redstone torch
You switch the Redstone Torch on.

There are 20 minutes to escape!

Bastion
There is a strange redstone contraption in the Bastion. If you use the Wither skull on the Unfinished Wither, you may get something important!

You can see an Unfinished Wither (closed) and a Redstone Torch here.

>unlock Unfinished Wither with Wither Skull
The Wither activates. Destruction quickly awaits the nether. A Chest Key is dropped for you to pick upUse the Fire Charge to unlock the Nether Portal and escape!

There are 7 minutes to escape!

>go south
Nether Fortress
The Nether Fortress is hot. There are  dead Blazes and Wither Skeletons on the floor. There is a Chest in front of you. There is a Bastion in the north of you. Your portal needs a Fire Charge.TIME IS RUNNING OUT!

You can see a Nether Portal, a Wither Skeleton Corpse (empty), a Blaze Corpse (in which is a Blaze Rod) and a Nether Fortress Chest (closed) here.

There are 6 minutes to escape!

* * *

>unlock Nether Fortress Chest with Chest Key
You unlock the Nether Fortress Chest.

There are 5 minutes to escape!

>Open Nether Fortress
You open the Nether Fortress Chest, revealing a Fire Charge.

There are 4 minutes to escape!

>Open Portal with Fire Charge
(first taking the Fire Charge)
You unlock the Nether Portal.

There are 3 minutes to escape!

>Enter nether Portal
(first opening the Nether Portal)

Overworld
You can see a Nether Portal here.

You made it through the portal to the Overworld. You are safe... for now.

    *** The End ***

Would you like to RESTART, RESTORE a saved game, QUIT or UNDO the last command?

* * *

Homework 11-8-2022
An Interactive Fiction by Radha
Release 1 / Serial number 221107 / Inform 7 v10.1.2 / D

Nether Fortress
The Nether Fortress is hot. There are  dead Blazes and Wither Skeletons on the floor. There is a Chest in front of you. There is a Bastion in the north of you. Your portal needs a Fire Charge.

You can see a Nether Portal, a Wither Skeleton Corpse (in which is a Wither Skull), a Blaze Corpse (in which is a Blaze Rod) and a Nether Fortress Chest (closed) here.

>take wither skull
Taken.

There are 20 minutes to escape!

* * *

>unlock Unfinished Wither with Wither Skull
The Wither activates. Destruction quickly awaits the nether. A Chest Key is dropped for you to pick upUse the Fire Charge to unlock the Nether Portal and escape!

There are 7 minutes to escape!

>go south
Nether Fortress
The Nether Fortress is hot. There are  dead Blazes and Wither Skeletons on the floor. There is a Chest in front of you. There is a Bastion in the north of you. Your portal needs a Fire Charge.TIME IS RUNNING OUT!

You can see a Nether Portal, a Wither Skeleton Corpse (empty), a Blaze Corpse (in which is a Blaze Rod) and a chest (closed) here.

There are 6 minutes to escape!

>Use Chest Key to unlock Chest
That's not a verb I recognise.

>Unlock Chest Key with Chest
(the Chest Key)
That doesn't seem to be something you can unlock.

There are 5 minutes to escape!

>Unlock the Chest with the Chest Key
(the Chest Key with the Chest Key)
That doesn't seem to be something you can unlock.

There are 4 minutes to escape!